//Level1
{{0,0,1025,1025,1025,1025,1025,1025,1025,1025,1025,0,0},{0,0,0,0,0,0,0,0,0,0,0,0,0},{1028,0,11,12,13,14,15,16,17,18,19,0,1026},{1028,0,20,49,48,47,46,45,44,43,42,0,1026},{1028,0,21,50,71,70,69,68,67,66,40,0,1026},{1028,0,22,51,72,85,84,83,82,65,41,0,1026},{1028,0,23,52,73,86,1,90,81,64,39,0,1026},{1028,0,24,53,74,87,88,89,80,63,38,0,1026},{1028,0,25,54,75,76,77,78,79,62,37,0,1026},{1028,0,26,55,56,57,58,59,60,61,36,0,1026},{1028,0,27,28,29,30,31,32,33,34,35,0,1026},{0,0,0,0,0,0,0,0,0,0,0,0,0},{0,0,1027,1027,1027,1027,1027,1027,1027,1027,1027,0,0}};

//Level2
{{0,0,0,0,0,0,0,0,0,0,0,0},{0,0,0,0,0,0,0,0,0,0,0,0},{0,0,0,0,0,0,0,0,0,0,0,0},{0,0,0,0,1000,1000,12,0,0,0,0,0},{0,0,0,1004,0,10,12,1001,0,0,0,0},{0,0,1005,1004,1,11,11,1001,0,0,0,0},{1006,1006,1005,14,14,13,13,0,1009,0,0,0},{0,0,0,0,15,15,1002,1002,1009,0,0,0},{1007,1007,1007,17,0,0,1009,1009,1009,0,0,0},{0,0,1007,1008,1008,1008,0,0,0,0,0,0},{0,0,0,0,0,0,0,0,0,0,0,0},{0,0,0,0,0,0,0,0,0,0,0,0}};

//Level3
{{0,0,0,0,0,0,0,1029,1029,1029,1029,1029,0,1030,1030},{0,0,0,0,0,0,0,1029,1034,0,1033,1031,0,1030,1030},{0,0,0,0,0,0,0,17,17,0,0,1022,0,1030,0},{1026,1026,1026,1026,1026,1026,1026,17,0,0,0,0,0,1030,0},{1026,0,0,0,0,12,12,13,0,1022,0,1021,0,1030,0},{1026,1026,1017,0,1012,1,0,13,13,0,14,1021,1021,0,0},{0,0,1017,0,0,1010,1010,1010,1010,15,14,0,1021,0,0},{0,0,1017,1017,0,0,0,0,0,0,0,1021,1021,0,0},{0,0,0,1017,1017,1017,1017,1017,1017,1017,1017,1021,0,0,0},{0,0,0,0,0,0,1017,1017,0,0,0,1021,0,0,0},{0,0,0,0,0,0,0,0,0,0,0,1021,0,0,0},{0,0,0,0,0,0,0,0,0,0,0,1021,0,0,0}};

//Level4
{{0,0,0,0,0,1011,1011,1011,1011,1011,0,0,0,0,0},{0,1017,1017,0,0,36,0,1011,0,37,0,0,1015,1015,0},{0,1017,10,10,10,0,0,0,0,0,17,17,17,1015,0},{0,0,10,10,10,0,75,0,64,0,17,17,17,0,0},{0,0,10,10,10,46,81,81,81,34,17,17,17,0,0},{1012,38,0,0,46,46,0,81,0,34,34,0,0,43,1014},{1012,0,0,61,82,0,49,0,50,0,80,74,0,0,1014},{1012,1012,0,0,82,82,0,1,0,80,80,0,0,1014,1014},{1012,0,0,76,82,0,48,0,51,0,80,83,0,0,1014},{1012,39,0,0,21,21,0,79,0,47,47,0,0,42,1014},{0,0,11,11,11,21,79,79,79,47,12,12,12,0,0},{0,0,11,11,11,0,67,0,73,0,12,12,12,0,0},{0,1003,11,11,11,0,0,0,0,0,12,12,12,1004,0},{0,1003,1003,0,0,40,0,1013,0,41,0,0,1004,1004,0},{0,0,0,0,0,1013,1013,1013,1013,1013,0,0,0,0,0}};

//Level5
{{0,0,1024,0,0,0,0,0,0,0,0,0,0,0,0,0,1025,0,0},{1020,0,84,84,84,84,84,1011,1011,1011,1011,1011,85,85,85,85,85,0,1021},{0,0,84,1017,1017,0,0,36,0,1011,0,37,0,0,1015,1015,85,0,0},{0,0,84,1017,10,10,10,0,0,0,0,0,17,17,17,1015,85,0,0},{0,0,84,0,10,10,10,0,75,0,64,0,17,17,17,0,85,0,0},{0,0,84,0,10,10,10,46,81,81,81,34,17,17,17,0,85,0,0},{0,0,1012,38,0,0,46,46,0,81,0,34,34,0,0,43,1014,0,0},{0,0,1012,0,0,61,82,0,49,0,50,0,80,74,0,0,1014,0,0},{0,0,1012,1012,0,0,82,82,0,1,0,80,80,0,0,1014,1014,0,0},{0,0,1012,0,0,76,82,0,48,0,51,0,80,83,0,0,1014,0,0},{0,0,1012,39,0,0,21,21,0,79,0,47,47,0,0,42,1014,0,0},{0,0,87,0,11,11,11,21,79,79,79,47,12,12,12,0,86,0,0},{0,0,87,0,11,11,11,0,67,0,73,0,12,12,12,0,86,0,0},{0,0,87,1003,11,11,11,0,0,0,0,0,12,12,12,1004,86,0,0},{0,0,87,1003,1003,0,0,40,0,1013,0,41,0,0,1004,1004,86,0,0},{1019,0,87,87,87,87,87,1013,1013,1013,1013,1013,86,86,86,86,86,0,1018},{0,0,1022,0,0,0,0,0,0,0,0,0,0,0,0,0,1023,0,0}};

//Level6
{{0,1003,1003,1002,1002,0,1005},{1004,0,0,13,0,0,1005},{1004,0,0,0,1006,0,1012},{1009,0,0,12,0,1011,1011},{1009,0,14,0,1,1013,0},{0,0,1001,0,1008,11,11},{0,0,1001,1007,0,1010,0}};

//Level7
{{0,0,13,0,1002,1002,0},{0,0,0,1006,15,0,0},{1010,1010,0,1006,0,12,12},{1005,0,1007,1007,14,11,0},{1005,1011,0,0,1,11,1009},{1003,1011,1004,1004,0,0,1009},{1012,1012,0,1008,1001,1001,0}};


//LUCA LEVEL 8
{{0,1033,0,1032,0,1031,0,1030,0,1029,0,1028},{1034,0,21,21,21,21,21,21,21,21,21,0},{0,0,21,1008,1008,1008,0,0,0,0,19,1023},{1035,0,21,1008,0,0,11,1003,1003,0,19,0},{0,0,21,1008,0,0,11,1,1003,0,19,1048},{1036,0,21,1008,17,17,1004,10,10,0,19,0},{0,0,21,0,0,0,16,0,0,1009,19,1047},{1037,1026,1026,1019,0,0,16,0,0,1009,19,0},{0,0,0,1019,1019,0,1009,1009,1009,1009,19,1046},{1038,0,1027,0,1025,19,19,19,19,19,19,0},{0,0,0,0,1025,0,0,0,0,0,0,1045},{1039,0,1040,0,1041,0,1042,0,1043,0,1044,0}};

//AUTO GENERATED

{{1007,1007,0,1012,1010,15,15},{0,0,13,1012,1006,1006,1011},{1014,1009,13,1013,0,0,1001},{1008,1008,1004,1015,0,11,1001},{0,0,0,1015,1,11,0},{14,12,1003,0,1002,0,0},{0,12,1003,0,1002,1005,1005}};

{{0,0,0,1008,1008,1003,1003},{1012,1015,1015,0,1006,1001,1001},{1012,0,1011,11,15,1010,1014},{0,0,18,11,0,0,1014},{1007,1016,12,16,1,1002,1002},{14,1013,1013,0,0,1004,1004},{14,13,13,1005,1005,1009,17}};

{{0,0,0,1008,0,0,1013},{0,1002,1002,1009,1009,1014,1014},{11,0,15,0,16,0,14},{11,1001,0,13,0,1006,1012},{1011,1001,12,13,1,1007,1012},{1011,1003,12,0,0,1004,0},{1015,1015,1005,1005,1010,1004,17}};

{{11,15,15,0,0,0,1005,0},{11,0,0,0,1015,1015,1005,0},{1004,1004,0,12,13,1014,16,0},{0,0,1002,0,19,0,1008,1003},{0,0,1007,20,20,0,1008,1003},{1011,1012,18,0,17,1,1001,0},{0,1012,18,0,14,1006,1001,0},{1009,1009,0,0,1013,1013,1010,1010}};

{{1007,1007,1001,1011,0,17,1008},{0,12,0,0,1002,0,1008},{0,11,0,14,1015,1004,1009},{1012,11,16,14,0,1004,1009},{1012,13,0,0,1,1013,0},{0,15,15,1010,1010,1013,1005},{1003,1003,0,1006,0,1014,1005}};

//AUTO GENERATE NOW

{{0,13,1009,0,1001,1001,1012},{17,13,1009,15,18,1007,1012},{11,11,19,15,0,1007,1014},{1004,0,1010,14,14,0,1002},{1013,0,12,12,1,1008,0},{20,1005,0,16,0,1008,1011},{1003,1005,0,1006,1006,0,1011}};

{{1010,1010,1008,0,1002,1013,1009},{13,13,1008,0,1005,1001,0},{0,1006,0,0,1005,1001,1007},{0,1006,0,15,15,0,1007},{1003,14,14,0,1,0,1012},{1003,11,11,0,0,0,1012},{0,12,0,1004,1004,1011,0}};

{{1011,0,1001,1001,1004,1008,0},{1011,0,0,0,1009,1008,0},{1014,11,14,14,13,16,0},{1014,11,0,0,13,0,1007},{1002,1003,1003,0,1,0,1007},{1006,0,1012,12,1005,1010,0},{0,15,0,1013,0,1010,0}};

{{1007,1007,1001,1011,0,17,1008},{0,12,0,0,1002,0,1008},{0,11,0,14,1015,1004,1009},{1012,11,16,14,0,1004,1009},{1012,13,0,0,1,1013,0},{0,15,15,1010,1010,1013,1005},{1003,1003,0,1006,0,1014,1005}};

//Alexander Level

{{1001,1001,1001,1001,1001,1005,1001,1001,1001,1001,1001,1001,1001,1001,1001,1001},{1001,0,0,0,0,1005,0,0,0,0,0,0,0,0,0,1001},{1001,0,1,0,0,1005,0,0,0,0,0,0,0,0,0,1001},{1001,0,0,30,30,30,30,30,0,0,0,23,0,0,0,1001},{1001,1004,1004,1004,1004,1004,0,23,23,23,0,23,0,0,0,1001},{1001,0,0,28,28,28,0,23,28,23,23,23,0,0,0,1001},{1001,24,24,24,24,28,28,28,28,0,0,0,0,21,21,1001},{1006,1006,1006,1006,0,0,0,0,1003,1003,1003,1003,1003,1003,1003,1001},{1001,0,0,0,0,0,0,1007,0,0,0,0,0,0,0,1001},{1001,0,0,0,0,0,0,0,15,0,0,0,0,16,16,1001},{1001,0,0,0,0,0,0,0,15,0,16,16,16,16,16,1001},{1001,0,0,0,0,0,15,15,15,0,0,0,0,0,0,1001},{1001,0,0,0,13,0,15,0,1002,0,0,0,0,0,0,1001},{1001,13,13,13,13,13,15,0,0,0,0,0,0,0,0,1001},{1001,1001,0,1001,1001,1001,1001,1001,1001,1001,1001,1001,1001,1001,1001,1001}};
//GOOD STANDALONE LEVELS:

{{105,102,103,0,101,0,0},{1004,1004,107,0,1011,0,1007},{0,1010,1010,1003,0,0,1007},{1002,0,0,0,0,0,0},{1002,0,109,104,0,1001,1001},{1006,0,0,0,1,1,1009},{1005,1005,108,1008,1008,106,0}};

{{0,1005,0,1010,1010,0,0},{0,0,0,103,1002,0,0},{1008,105,105,103,1,1,1001},{1008,0,0,0,0,0,1001},{106,106,1007,0,1012,1009,1004},{1006,101,104,104,0,1009,1004},{1003,1003,0,102,0,0,1011}};

{{0,0,0,0,1010,1010,0},{0,0,0,0,0,1003,0},{1004,1004,0,0,0,1,0},{101,0,104,1001,107,1,1007},{101,0,0,1008,0,0,1009},{102,102,103,105,106,0,1009},{0,0,1005,1006,1002,1002,0}};

{{0,0,1004,1004,1008,0,1010},{1009,0,1013,0,0,102,1006},{0,105,1,0,0,102,1005},{0,1007,1,103,0,0,1005},{0,0,0,104,0,0,0},{0,1003,1002,1001,1012,1012,101},{1011,1003,1002,1001,0,0,101}};

{{0,0,1004,0,0,0,0,1012,1012,108,0},{0,0,1004,0,0,0,0,1012,1012,0,0},{0,1013,1013,0,0,0,1006,1006,1010,0,103},{0,0,0,0,0,0,0,0,1003,0,103},{0,1005,1005,0,0,105,105,106,1,1007,0},{0,1005,1005,0,1011,1011,0,106,1,1009,0},{0,0,0,0,0,0,0,102,0,1009,0},{101,0,107,0,1014,1001,1001,0,0,0,104},{101,0,0,1008,0,1001,1001,1002,1002,0,0}};

//little good mechanic:

{{0,1009,0,1011,1008,0,1012},{1010,0,0,103,1008,1013,1012},{1010,102,0,0,0,1013,1005},{1002,0,104,0,101,0,1001},{1004,0,104,105,101,0,0},{1004,1,1,105,0,1003,1003},{0,1007,0,1006,0,0,0}};

{{0,0,0,0,1010,102,1002},{0,0,0,0,0,102,0},{0,0,1008,1008,105,0,0},{1003,106,0,101,101,0,1005},{1003,106,0,0,0,103,1004},{0,1006,0,1,0,104,1004},{0,1006,1007,1007,1009,0,1001}};

{{0,0,1004,1004,1008,0,1010},{1009,0,1013,0,0,102,1006},{0,105,1,0,0,102,1005},{0,1007,1,103,0,0,1005},{0,0,0,104,0,0,0},{0,1003,1002,1001,1012,1012,101},{1011,1003,1002,1001,0,0,101}};

{{0,1004,1004,0,1009,1009,0},{0,102,1007,0,1008,1008,1011},{0,0,0,0,0,1,1011},{0,103,1001,107,107,1,0},{0,101,0,104,106,0,1010},{1005,105,0,104,106,0,1010},{1002,1003,1003,0,1006,1006,0}};

{{0,0,0,0,1010,102,1002},{0,0,0,0,0,102,0},{0,0,1008,1008,105,0,0},{1003,106,0,101,101,0,1005},{1003,106,0,0,0,103,1004},{0,1006,0,1,0,104,1004},{0,1006,1007,1007,1009,0,1001}};

{{1004,0,1001,1001,0,0,0},{1004,0,103,102,102,0,1006},{1005,0,103,0,1,1,1006},{1005,0,0,0,1008,101,106},{0,104,105,105,1008,101,1007},{0,104,0,1003,0,0,1007},{0,1002,0,1003,0,0,0}};

{{105,1010,1004,1004,1008,0,0},{105,0,1005,0,0,108,108},{1006,104,1005,107,109,109,0},{1003,104,0,107,106,106,1009},{1003,0,0,0,0,0,1002},{1007,1007,101,1,102,102,1002},{0,103,1011,1011,0,1001,0}};

{{0,0,0,1008,1008,0,101},{0,1004,1,1,0,0,1007},{0,1004,0,105,0,0,1007},{0,0,0,0,1003,0,0},{0,102,0,1001,0,1006,0},{104,102,0,0,0,1009,1002},{104,0,0,0,103,1005,0}};

{{106,0,102,0,0,103},{1005,1001,102,1008,0,1007},{0,0,0,104,104,1007},{1004,0,105,1,1,1009},{1004,0,101,0,0,1009},{0,0,1002,1006,1003,1003}};

{{1010,0,0,0,0,1003,1003,0,0,0,0},{1006,102,1002,1002,0,1003,1003,0,0,0,0},{1006,102,0,0,0,0,0,0,0,0,0},{0,103,0,106,106,101,0,1007,0,107,0},{1012,103,0,0,104,105,0,1007,0,107,1001},{1012,0,1,1,104,0,0,0,0,0,1001},{108,108,1,1,0,0,0,0,1011,0,110},{108,108,1009,1009,0,0,109,1004,1005,1005,110},{1008,1008,1009,1009,0,0,0,1004,1005,1005,0}};

{{0,0,0,0,1001,0,0,0},{0,0,1009,1009,1001,0,1004,1004},{106,106,0,0,0,0,0,0},{1011,1011,1,1,105,105,1010,0},{1011,1011,1,1,0,104,1010,101},{0,0,103,103,0,0,0,0},{0,0,0,0,0,108,108,0},{0,1002,1002,0,1003,0,107,107},{1005,1002,1002,1008,1003,0,0,0},{0,0,0,1008,1006,1006,0,1007},{102,0,0,0,0,0,0,1007}};

{{0,1005,1005,0,0,1009,0,0,0,0},{0,1005,1005,1004,0,0,0,0,0,1013},{0,1002,0,1004,0,108,0,0,0,1013},{1008,0,0,1014,1014,0,1010,1010,107,107},{0,1001,0,1014,1014,0,0,0,0,0},{0,0,0,0,0,0,0,0,0,0},{1012,1012,0,1,1,0,1003,0,105,0},{1012,1012,101,1,1,0,1003,0,0,0},{103,103,109,0,106,0,1011,0,0,0},{0,0,0,104,0,0,1011,0,0,0},{0,0,0,1007,1007,0,1006,102,0,0}};

{{1009,1009,110,110,0,0,0},{1009,1009,1007,1012,1012,108,108},{1011,1011,1,0,0,1004,0},{1011,1011,106,106,0,1008,1008},{1006,1006,104,0,0,1002,0},{1006,1006,101,1010,1010,1002,0},{103,0,0,1010,1010,0,0},{103,0,0,0,105,102,1003},{0,1005,0,0,109,109,1003},{0,107,1001,0,109,109,0}};

{{0,101,0,1010,1010,0,0,0,0,0,0},{1004,1004,0,1010,1010,0,0,0,0,1003,0},{0,109,109,103,0,110,110,0,0,1003,0},{1002,1002,0,103,102,110,110,0,0,0,0},{1002,1002,1,1,0,0,1007,1007,0,0,0},{108,108,1,1,106,0,0,0,0,1001,0},{108,108,104,1011,1006,1006,0,0,0,1009,1009},{1008,0,0,1011,0,0,107,1005,1005,1009,1009},{1008,0,105,0,0,0,107,1005,1005,0,0}};

{{0,0,0,0,0,107,0,0,0},{1011,1004,1004,0,1005,0,0,0,0},{0,0,0,1013,1013,1014,1014,0,0},{0,0,108,0,103,0,1010,104,0},{0,1009,1009,1,1,0,0,104,1007},{0,1009,1009,1,1,0,110,0,1007},{109,1002,102,102,106,0,110,0,0},{109,1001,0,0,0,0,101,1012,1012},{0,1001,0,0,105,105,0,1012,1012},{0,1006,0,0,0,1003,0,0,0},{1008,1008,0,0,0,1003,0,0,0}};

{{0,109,0,1001,1001,1009,1009,0},{1002,0,0,0,1013,1013,0,0},{0,1008,1008,0,0,0,0,1007},{0,1008,1008,110,0,105,0,1007},{1012,0,0,1,1,102,1005,1005},{1012,0,0,1,1,107,1005,1005},{1003,0,0,106,106,104,103,0},{1003,1010,1014,1014,0,0,1011,1011},{1004,0,1014,1014,0,0,101,0},{0,0,0,108,108,0,101,1006}};

{{0,0,1007,1007,0,102,102,1009,1009,0,0},{0,0,1007,1007,105,0,0,1009,1009,0,0},{0,0,0,0,0,1011,1011,0,0,0,0},{0,1006,0,0,0,0,0,0,1003,1003,0},{0,1004,0,0,0,0,0,0,0,0,0},{1008,0,0,0,101,101,104,0,0,0,0},{1001,0,0,0,1,1,104,0,0,1002,0},{0,1010,1010,0,1,1,1005,0,1012,1012,0},{0,0,0,0,1013,1013,1005,0,1012,1012,103}};

{{0,0,0,0,0,0,0,102,0},{104,0,1008,1010,0,1009,0,1002,1002},{0,0,1008,1,1,1009,0,1002,1002},{1004,0,0,107,107,1001,0,1005,1005},{1004,0,0,0,0,0,0,1005,1005},{0,0,1003,1003,0,0,0,105,0},{0,0,1003,1003,103,103,1011,105,0},{0,106,1007,0,0,0,1011,0,101},{0,106,1007,0,0,1006,0,1012,1012}};

{{0,1012,1012,0,0,1011,1011,0,106,106},{0,1012,1012,0,0,1011,1011,0,0,0},{0,1,0,1003,102,105,0,0,0,0},{1005,1,0,0,102,0,0,0,1013,0},{1005,0,0,104,0,1009,1009,0,1013,0},{1007,1007,0,103,0,1009,1009,1002,0,101},{0,1001,0,103,0,0,0,1002,0,0},{0,1001,1006,0,1008,1008,0,0,1004,1004},{0,0,0,1010,1008,1008,0,0,0,0}};

{{0,108,0,0,104,104,0,0,0,0},{0,0,0,0,1009,0,1002,0,0,0},{0,0,0,0,1009,0,0,1004,0,0},{102,102,1001,0,101,0,0,1,1,1006},{0,106,1001,0,103,103,105,0,0,1006},{0,106,0,0,0,0,105,0,1005,1005},{0,0,109,0,0,1007,1007,0,1005,1005},{0,0,109,1003,1003,1007,1007,0,0,107},{0,0,0,1008,0,0,0,0,0,107}};

{{0,1009,1009,0,1014,1014,0,0,0,0},{0,1009,1009,0,106,0,0,1005,0,1006},{0,0,0,0,106,1,1,0,0,103},{0,102,102,107,107,1,1,104,1007,103},{101,101,1001,1001,0,0,0,0,0,0},{0,1013,0,0,105,0,0,1002,1011,1011},{0,1013,1010,1010,0,1008,1008,0,0,0},{0,1003,0,0,0,0,1012,0,1004,0},{0,0,0,0,0,0,1012,0,1004,0}};

{{110,110,0,0,1002,0,0,0,0,0,0},{110,110,0,0,1002,0,0,1006,1006,0,0},{1003,1003,1009,0,0,0,1001,1001,0,0,0},{1003,1003,1009,0,0,0,1,1,0,1005,1005},{0,0,1008,102,0,107,107,109,109,1005,1005},{0,0,1008,0,0,107,107,109,109,105,105},{108,0,0,1007,1007,1010,1010,0,0,105,105},{108,104,104,1007,1007,1010,1010,0,1012,1012,0},{106,104,104,1004,0,0,0,0,0,101,0},{1011,0,0,1004,103,103,0,0,0,101,0}};

{{0,0,0,1009,1010,1010,105,105},{0,0,0,0,1,0,1005,1005},{0,1007,1007,0,1,0,1005,1005},{103,1007,1007,0,106,0,0,0},{1011,0,1002,1002,106,101,1006,1006},{1011,0,1002,1002,0,0,1006,1006},{0,1003,1003,0,0,0,0,0},{0,0,0,0,1008,102,0,0},{0,0,104,0,0,0,0,0},{0,0,0,0,1001,1004,1004,0}};
//NEW GEN





//21 big: 21
{{0,0,0,1009,1010,1010,105,105},{0,0,0,0,1,0,1005,1005},{0,1007,1007,0,1,0,1005,1005},{103,1007,1007,0,106,0,0,0},{1011,0,1002,1002,106,101,1006,1006},{1011,0,1002,1002,0,0,1006,1006},{0,1003,1003,0,0,0,0,0},{0,0,0,0,1008,102,0,0},{0,0,104,0,0,0,0,0},{0,0,0,0,1001,1004,1004,0}};

//21 big: 21
{{0,0,0,1009,1010,1010,105,105},{0,0,0,0,1,0,1005,1005},{0,1007,1007,0,1,0,1005,1005},{103,1007,1007,0,106,0,0,0},{1011,0,1002,1002,106,101,1006,1006},{1011,0,1002,1002,0,0,1006,1006},{0,1003,1003,0,0,0,0,0},{0,0,0,0,1008,102,0,0},{0,0,104,0,0,0,0,0},{0,0,0,0,1001,1004,1004,0}};

//21 big: 21
{{0,0,1004,0,0,0,0,1012,1012,108,0},{0,0,1004,0,0,0,0,1012,1012,0,0},{0,1013,1013,0,0,0,1006,1006,1010,0,103},{0,0,0,0,0,0,0,0,1003,0,103},{0,1005,1005,0,0,105,105,106,1,1007,0},{0,1005,1005,0,1011,1011,0,106,1,1009,0},{0,0,0,0,0,0,0,102,0,1009,0},{101,0,107,0,1014,1001,1001,0,0,0,104},{101,0,0,1008,0,1001,1001,1002,1002,0,0}};

//21 big: 21
{{0,0,0,1009,1010,1010,105,105},{0,0,0,0,1,0,1005,1005},{0,1007,1007,0,1,0,1005,1005},{103,1007,1007,0,106,0,0,0},{1011,0,1002,1002,106,101,1006,1006},{1011,0,1002,1002,0,0,1006,1006},{0,1003,1003,0,0,0,0,0},{0,0,0,0,1008,102,0,0},{0,0,104,0,0,0,0,0},{0,0,0,0,1001,1004,1004,0}};

//21 big: 21
{{0,0,1004,0,0,0,0,1012,1012,108,0},{0,0,1004,0,0,0,0,1012,1012,0,0},{0,1013,1013,0,0,0,1006,1006,1010,0,103},{0,0,0,0,0,0,0,0,1003,0,103},{0,1005,1005,0,0,105,105,106,1,1007,0},{0,1005,1005,0,1011,1011,0,106,1,1009,0},{0,0,0,0,0,0,0,102,0,1009,0},{101,0,107,0,1014,1001,1001,0,0,0,104},{101,0,0,1008,0,1001,1001,1002,1002,0,0}};

//21 big: 21
{{0,0,1004,0,0,0,0,1012,1012,108,0},{0,0,1004,0,0,0,0,1012,1012,0,0},{0,1013,1013,0,0,0,1006,1006,1010,0,103},{0,0,0,0,0,0,0,0,1003,0,103},{0,1005,1005,0,0,105,105,106,1,1007,0},{0,1005,1005,0,1011,1011,0,106,1,1009,0},{0,0,0,0,0,0,0,102,0,1009,0},{101,0,107,0,1014,1001,1001,0,0,0,104},{101,0,0,1008,0,1001,1001,1002,1002,0,0}};

//21 big: 21
{{0,0,0,1009,1010,1010,105,105},{0,0,0,0,1,0,1005,1005},{0,1007,1007,0,1,0,1005,1005},{103,1007,1007,0,106,0,0,0},{1011,0,1002,1002,106,101,1006,1006},{1011,0,1002,1002,0,0,1006,1006},{0,1003,1003,0,0,0,0,0},{0,0,0,0,1008,102,0,0},{0,0,104,0,0,0,0,0},{0,0,0,0,1001,1004,1004,0}};

//21 big: 21
{{0,0,0,1009,1010,1010,105,105},{0,0,0,0,1,0,1005,1005},{0,1007,1007,0,1,0,1005,1005},{103,1007,1007,0,106,0,0,0},{1011,0,1002,1002,106,101,1006,1006},{1011,0,1002,1002,0,0,1006,1006},{0,1003,1003,0,0,0,0,0},{0,0,0,0,1008,102,0,0},{0,0,104,0,0,0,0,0},{0,0,0,0,1001,1004,1004,0}};

//21 big: 21
{{0,0,0,1009,1010,1010,105,105},{0,0,0,0,1,0,1005,1005},{0,1007,1007,0,1,0,1005,1005},{103,1007,1007,0,106,0,0,0},{1011,0,1002,1002,106,101,1006,1006},{1011,0,1002,1002,0,0,1006,1006},{0,1003,1003,0,0,0,0,0},{0,0,0,0,1008,102,0,0},{0,0,104,0,0,0,0,0},{0,0,0,0,1001,1004,1004,0}};

{{0,1001,1001,0,0,0,1007,0,0,1006,1006},{0,1001,1001,0,1004,1004,1007,0,0,1006,1006},{0,0,0,105,105,0,0,1002,0,0,0},{1005,0,0,1,1,0,0,0,1009,0,0},{1005,106,102,1,1,104,0,0,1009,0,0},{0,0,102,0,0,104,0,0,0,0,0},{0,0,101,101,0,0,0,0,0,0,0},{0,0,101,101,1008,1008,0,0,107,0,0},{0,0,0,108,108,0,0,0,1013,1010,0},{0,0,0,0,1012,1012,0,0,1011,0,0},{1003,1003,0,0,0,103,103,0,1011,0,0}};

//Very nice joint symmetry generation
{{1002,1002,0,1005,1005,101,101,101,1005,1005,0,1002,1002},{0,102,0,105,0,1003,0,1003,0,105,0,102,0},{0,0,1006,103,0,0,0,0,0,103,1006,0,0},{0,0,1006,103,0,0,0,0,0,103,1006,0,0},{0,104,104,0,0,106,106,106,0,0,104,104,0},{1004,104,104,0,0,0,0,0,0,0,104,104,1004},{1004,0,0,1001,0,0,1,0,0,1001,0,0,1004},{1004,104,104,0,0,0,0,0,0,0,104,104,1004},{0,104,104,0,0,106,106,106,0,0,104,104,0},{0,0,1006,103,0,0,0,0,0,103,1006,0,0},{0,0,1006,103,0,0,0,0,0,103,1006,0,0},{0,102,0,105,0,1003,0,1003,0,105,0,102,0},{1002,1002,0,1005,1005,101,101,101,1005,1005,0,1002,1002}};

//Another nice joint symmetry level
{{0,0,0,1005,1005,0,0,0,1005,1005,0,0,0},{101,1002,1001,1001,0,1006,1006,1006,0,1001,1001,1002,101},{101,104,1001,1001,0,1006,1006,1006,0,1001,1001,104,101},{0,104,0,0,0,0,0,0,0,0,0,104,0},{105,105,0,0,0,0,103,0,0,0,0,105,105},{105,105,0,1003,1004,1004,0,1004,1004,1003,0,105,105},{102,102,0,0,1004,1004,1,1004,1004,0,0,102,102},{105,105,0,1003,1004,1004,0,1004,1004,1003,0,105,105},{105,105,0,0,0,0,103,0,0,0,0,105,105},{0,104,0,0,0,0,0,0,0,0,0,104,0},{101,104,1001,1001,0,1006,1006,1006,0,1001,1001,104,101},{101,1002,1001,1001,0,1006,1006,1006,0,1001,1001,1002,101},{0,0,0,1005,1005,0,0,0,1005,1005,0,0,0}};

//stopid
{{103,103,1001,0,44,22,22,22,1023,125,125},{0,102,101,0,44,126,22,22,123,124,22},{1005,102,0,0,44,126,22,22,22,124,1027},{0,0,0,1003,44,22,22,1025,22,22,22},{22,22,1026,22,110,110,88,44,1048,44,44},{11,1013,1013,1017,88,67,55,1050,1046,1046,44},{11,11,1015,11,99,77,77,33,1037,33,33},{11,11,11,1014,55,55,33,1036,33,33,33},{1016,113,11,11,55,159,33,33,33,135,1038},{11,113,112,11,55,159,33,33,134,135,33},{114,114,1012,11,55,55,33,33,1034,136,136}};

//weird connection problem
{{1004,1004,0,1051,1027,1027,0,1028,1028},{0,1006,105,1049,0,1025,129,1030,0},{104,1005,105,1049,125,1025,129,1029,128},{127,1029,0,222,0,198,0,1053,151},{0,1014,1014,198,1,162,1050,1050,0},{115,1017,0,210,0,186,0,1041,139},{116,1017,117,1061,161,1037,141,1041,140},{0,1018,117,1061,0,1037,141,1042,0},{1016,1016,0,1063,1063,1039,0,1040,1040}};

//3-block puzzle cool!!
{{101,0,1001,1079,1053,0,153},{0,0,0,0,0,0,0},{1002,103,102,180,154,155,1054},{1236,1237,0,1,0,1289,1288},{1210,311,310,388,362,363,1262},{0,0,0,0,0,0,0},{309,0,1209,1287,1261,0,361}};


//easy but beautiful level
ddd l1006={{102,101,101,1001,1001,0,1067,1067,167,167,168},{110,101,101,1001,1001,1101,1067,1067,167,167,176},{110,109,109,104,105,204,171,170,175,175,176},{0,0,0,107,0,0,0,173,0,0,0},{0,1003,1003,108,106,202,172,174,1069,1069,0},{0,1300,1300,0,403,1,469,0,1366,1366,0},{0,1267,1267,372,370,466,436,438,1333,1333,0},{0,0,0,371,0,0,0,437,0,0,0},{374,373,373,368,369,468,435,434,439,439,440},{374,365,365,1265,1265,1365,1331,1331,431,431,440},{366,365,365,1265,1265,0,1331,1331,431,431,432}};

//very cool mechanic
{{1005,1005,1009,1010,0,218,0,1088,1087,1083,1083},{1005,1005,104,0,1012,0,1090,0,182,1083,1083},{103,1002,104,0,102,224,180,0,182,1080,181},{1007,1002,1006,0,1011,1128,1089,0,1084,1080,1085},{1003,1001,1006,0,1004,0,1082,0,1084,1079,1081},{1359,457,456,0,0,1,0,0,534,535,1437},{1315,1313,1318,0,1316,0,1394,0,1396,1391,1393},{1319,1314,1318,0,1323,1440,1401,0,1396,1392,1397},{415,1314,416,0,414,536,492,0,494,1392,493},{1317,1317,416,0,1324,0,1402,0,494,1395,1395},{1317,1317,1321,1322,0,530,0,1400,1399,1395,1395}};

//easy, but might not easily find it.
ddd l1010={{104,104,0,0,1005,1110,1075,0,0,174,174},{108,101,1001,1001,1002,1107,1072,1071,1071,171,178},{108,103,105,109,109,211,179,179,175,173,178},{0,110,110,102,0,0,0,172,180,180,0},{1003,0,0,102,1004,0,1074,172,0,0,1073},{1318,0,422,422,1319,1,1389,492,492,0,1388},{1283,0,0,382,1284,0,1354,452,0,0,1353},{0,390,390,382,0,0,0,452,460,460,0},{388,383,385,389,389,491,459,459,455,453,458},{388,381,1281,1281,1282,1387,1352,1351,1351,451,458},{384,384,0,0,1285,1390,1355,0,0,454,454}};



//15 big: 15
ddd l1013={{104,104,0,0,0,0,0,158,158},{103,0,0,1003,0,1057,0,0,157},{0,0,102,102,0,156,156,0,0},{1001,0,101,0,1083,0,155,0,1055},{1244,0,344,0,1,0,398,0,1298},{1217,0,317,0,1299,0,371,0,1271},{0,0,318,318,0,372,372,0,0},{319,0,0,1219,0,1273,0,0,373},{320,320,0,0,0,0,0,374,374}};

//15 big: 15
ddd l1014={{1002,0,0,1007,1094,1065,0,0,1060},{1008,1008,1003,1001,1088,1059,1061,1066,1066},{0,0,0,0,0,0,0,0,0},{0,1005,1004,101,188,159,1062,1063,0},{1267,1267,1265,0,1,0,1323,1325,1325},{0,1237,1236,333,420,391,1294,1295,0},{0,0,0,0,0,0,0,0,0},{1240,1240,1235,1233,1320,1291,1293,1298,1298},{1234,0,0,1239,1326,1297,0,0,1292}};

//16 big: 16
ddd l1015={{1003,1003,1001,0,0,0,1055,1057,1057},{0,0,0,1002,1083,1056,0,0,0},{0,0,0,1002,1083,1056,0,0,0},{1004,102,0,103,0,157,0,156,1058},{1247,345,0,344,1,398,0,399,1301},{1220,318,0,319,0,373,0,372,1274},{0,0,0,1218,1299,1272,0,0,0},{0,0,0,1218,1299,1272,0,0,0},{1219,1219,1217,0,0,0,1271,1273,1273}};

//17 big: 17
ddd l1016={{101,0,103,1001,1088,1059,161,0,159},{1003,1003,0,0,0,0,0,1061,1061},{1005,1005,104,104,189,162,162,1063,1063},{1005,1005,1004,0,189,0,1062,1063,1063},{1263,0,1265,0,1,0,1323,0,1321},{1237,1237,1236,0,421,0,1294,1295,1295},{1237,1237,336,336,421,394,394,1295,1295},{1235,1235,0,0,0,0,0,1293,1293},{333,0,335,1233,1320,1291,393,0,391}};

//unintuitive!!
ddd l1017={{0,1001,1002,1003,1087,1059,1058,1057,0},{0,1001,1002,1004,0,1060,1058,1057,0},{0,0,0,1004,0,1060,0,0,0},{1005,0,101,101,186,157,157,0,1061},{1257,0,0,355,1,411,0,0,1313},{1229,0,325,325,410,381,381,0,1285},{0,0,0,1228,0,1284,0,0,0},{0,1225,1226,1228,0,1284,1282,1281,0},{0,1225,1226,1227,1311,1283,1282,1281,0}};

//meh
ddd l1018={{1001,1005,0,1002,1089,1060,0,1063,1059},{0,1005,0,0,0,0,0,1063,0},{1003,1003,1004,0,188,0,1062,1061,1061},{0,0,1004,103,188,161,1062,0,0},{1267,1267,0,363,1,421,0,1325,1325},{0,0,1236,335,420,393,1294,0,0},{1235,1235,1236,0,420,0,1294,1293,1293},{0,1237,0,0,0,0,0,1295,0},{1233,1237,0,1234,1321,1292,0,1295,1291}};

//yet another meh.
ddd l1019={{0,0,102,1004,1091,1062,160,0,0},{0,101,102,0,0,0,160,159,0},{1005,101,0,0,190,0,0,159,1063},{0,1003,104,104,190,162,162,1061,0},{1263,1263,1262,0,1,0,1320,1321,1321},{0,1235,336,336,422,394,394,1293,0},{1237,333,0,0,422,0,0,391,1295},{0,333,334,0,0,0,392,391,0},{0,0,334,1236,1323,1294,392,0,0}};

//21 big: 21
ddd l1022={{0,1005,1005,1007,188,1065,1063,1063,0},{0,1003,0,1007,0,1065,0,1061,0},{1002,1006,0,102,189,160,0,1064,1060},{0,1006,0,1004,1091,1062,0,1064,0},{0,1262,0,0,1,0,0,1320,0},{0,1238,0,1236,1323,1294,0,1296,0},{1234,1238,0,334,421,392,0,1296,1292},{0,1235,0,1239,0,1297,0,1293,0},{0,1237,1237,1239,420,1297,1295,1295,0}};

//extremely cool
ddd l1023={{0,1005,1004,0,0,0,1064,1065,0},{102,1005,1003,1003,0,1063,1063,1065,162},{102,0,101,0,1092,0,161,0,162},{1001,105,103,103,194,163,163,165,1061},{1271,0,0,0,1,0,0,0,1331},{1241,345,343,343,434,403,403,405,1301},{342,0,341,0,1332,0,401,0,402},{342,1245,1243,1243,0,1303,1303,1305,402},{0,1245,1244,0,0,0,1304,1305,0}};

//quite nice
ddd l1029={{0,0,0,1008,0,0,0,1070,0,0,0},{1001,1007,0,1008,1006,1099,1068,1070,0,1069,1063},{1002,1002,0,1003,1003,0,1065,1065,0,1064,1064},{1002,1002,0,101,0,0,0,163,0,1064,1064},{0,1005,0,101,0,1097,0,163,0,1067,0},{0,1284,0,381,382,1,444,443,0,1346,0},{0,1253,0,349,0,1345,0,411,0,1315,0},{1250,1250,0,349,0,0,0,411,0,1312,1312},{1250,1250,0,1251,1251,0,1313,1313,0,1312,1312},{1249,1255,0,1256,1254,1347,1316,1318,0,1317,1311},{0,0,0,1256,0,0,0,1318,0,0,0}};

//fooled me 717423 depth: 21 traps: 0 toolong: 324
ddd l1030={{0,0,1005,1004,1001,201,1067,1070,1071,0,0},{1009,0,1005,1004,1006,1105,1072,1070,1071,0,1075},{1010,0,0,101,0,1106,0,167,0,0,1076},{1008,0,0,101,1002,1106,1068,167,0,0,1074},{1008,0,0,103,103,0,169,169,0,0,1074},{1300,0,0,400,400,1,466,466,0,0,1366},{1272,0,0,367,367,0,433,433,0,0,1338},{1272,0,0,365,1266,1370,1332,431,0,0,1338},{1274,0,0,365,0,1370,0,431,0,0,1340},{1273,0,1269,1268,1270,1369,1336,1334,1335,0,1339},{0,0,1269,1268,1265,465,1331,1334,1335,0,0}};


//fooled me sim 767736 depth: 18 traps: 0 toolong: 827
ddd l1032={{102,106,0,103,1001,1108,1069,171,0,174,170},{104,106,0,0,0,0,0,0,0,174,172},{104,0,1005,1005,0,0,0,1073,1073,0,172},{105,108,108,1004,107,209,175,1072,176,176,173},{105,1003,1002,1002,107,209,175,1070,1070,1071,173},{0,1309,0,0,407,1,475,0,0,1377,0},{377,1275,1274,1274,379,481,447,1342,1342,1343,445},{377,380,380,1276,379,481,447,1344,448,448,445},{376,0,1277,1277,0,0,0,1345,1345,0,444},{376,378,0,0,0,0,0,0,0,446,444},{374,378,0,375,1273,1380,1341,443,0,446,442}};

//892772 depth: 19 traps: 0 toolong: 1407
ddd l1033={{102,1001,0,0,0,0,0,0,0,1061,162},{0,1001,1005,1005,1004,0,1064,1065,1065,1061,0},{104,1006,1005,1005,0,0,0,1065,1065,1066,164},{0,1006,0,0,101,191,161,0,0,1066,0},{1002,0,0,103,103,1093,163,163,0,0,1062},{1272,0,0,373,373,1,433,433,0,0,1332},{1242,0,0,343,343,1333,403,403,0,0,1302},{0,1246,0,0,341,431,401,0,0,1306,0},{344,1246,1245,1245,0,0,0,1305,1305,1306,404},{0,1241,1245,1245,1244,0,1304,1305,1305,1301,0},{342,1241,0,0,0,0,0,0,0,1301,402}};

//955440 depth: 20 traps: 0 toolong: 2558
ddd l1034={{107,104,104,1002,1002,0,1066,1066,168,168,171},{0,104,104,1002,1002,1097,1066,1066,168,168,0},{0,101,0,0,0,1097,0,0,0,165,0},{106,106,1003,105,108,204,172,169,1067,170,170},{1004,0,1003,0,108,204,172,0,1067,0,1068},{1292,390,0,0,391,1,455,0,0,454,1356},{1260,0,1259,0,364,460,428,0,1323,0,1324},{362,362,1259,361,364,460,428,425,1323,426,426},{0,357,0,0,0,1353,0,0,0,421,0},{0,360,360,1258,1258,1353,1322,1322,424,424,0},{363,360,360,1258,1258,0,1322,1322,424,424,427}};

//1046346 depth: 21 traps: 0 toolong: 2748
ddd l1035={{0,0,0,0,1001,1097,1065,0,0,0,0},{1005,1005,101,1007,0,0,0,1071,165,1069,1069},{1005,1005,0,1007,104,1099,168,1071,0,1069,1069},{1002,1006,0,1004,0,0,0,1068,0,1070,1066},{1002,0,102,102,0,0,0,166,166,0,1066},{1296,0,0,391,391,1,455,455,0,0,1360},{1258,0,358,358,0,0,0,422,422,0,1322},{1258,1262,0,1260,0,0,0,1324,0,1326,1322},{1261,1261,0,1263,360,1355,424,1327,0,1325,1325},{1261,1261,357,1263,0,0,0,1327,421,1325,1325},{0,0,0,0,1257,1353,1321,0,0,0,0}};

//37632 depth: 24 traps: 0 toolong: 3409
ddd l1036={{105,104,0,1003,0,0,0,1069,0,170,171},{1005,1005,0,1003,1006,1105,1072,1069,0,1071,1071},{0,1002,0,102,0,0,0,168,0,1068,0},{101,103,103,102,1001,0,1067,168,169,169,167},{101,0,107,107,1001,0,1067,173,173,0,167},{1301,1301,0,403,403,1,469,469,0,1367,1367},{365,0,371,371,1265,0,1331,437,437,0,431},{365,367,367,366,1265,0,1331,432,433,433,431},{0,1266,0,366,0,0,0,432,0,1332,0},{1269,1269,0,1267,1270,1369,1336,1333,0,1335,1335},{369,368,0,1267,0,0,0,1333,0,434,435}};

//139752 depth: 27 traps: 0 toolong: 4012
ddd l1037={{0,1009,0,107,1008,1119,1082,181,0,1083,0},{1007,1009,101,107,1008,1119,1082,181,175,1083,1081},{1007,105,105,0,0,0,0,0,179,179,1081},{1005,0,102,1003,104,214,178,1077,176,0,1079},{1001,1006,1006,0,0,214,0,0,1080,1080,1075},{439,1337,1343,0,1335,1,1409,0,1417,1411,513},{1297,1302,1302,0,0,510,0,0,1376,1376,1371},{1301,0,398,1299,400,510,474,1373,472,0,1375},{1303,401,401,0,0,0,0,0,475,475,1377},{1303,1305,397,403,1304,1415,1378,477,471,1379,1377},{0,1305,0,403,1304,1415,1378,477,0,1379,0}};

//371223 depth: 27 traps: 0 toolong: 6779
ddd l1038={{0,103,103,0,1004,1100,1068,0,167,167,0},{0,107,1002,1002,1004,1100,1068,1066,1066,171,0},{0,0,1002,1002,104,200,168,1066,1066,0,0},{1001,0,0,105,0,1099,0,169,0,0,1065},{1005,101,102,102,0,1099,0,166,166,165,1069},{1293,0,0,394,394,1,458,458,0,0,1357},{1261,357,358,358,0,1355,0,422,422,421,1325},{1257,0,0,361,0,1355,0,425,0,0,1321},{0,0,1258,1258,360,456,424,1322,1322,0,0},{0,363,1258,1258,1260,1356,1324,1322,1322,427,0},{0,359,359,0,1260,1356,1324,0,423,423,0}};

