
{{0,0,1025,1025,1025,1025,1025,1025,1025,1025,1025,0,0},{0,0,0,0,0,0,0,0,0,0,0,0,0},{1028,0,11,12,13,14,15,16,17,18,19,0,1026},{1028,0,20,49,48,47,46,45,44,43,42,0,1026},{1028,0,21,50,71,70,69,68,67,66,40,0,1026},{1028,0,22,51,72,85,84,83,82,65,41,0,1026},{1028,0,23,52,73,86,1,90,81,64,39,0,1026},{1028,0,24,53,74,87,88,89,80,63,38,0,1026},{1028,0,25,54,75,76,77,78,79,62,37,0,1026},{1028,0,26,55,56,57,58,59,60,61,36,0,1026},{1028,0,27,28,29,30,31,32,33,34,35,0,1026},{0,0,0,0,0,0,0,0,0,0,0,0,0},{0,0,1027,1027,1027,1027,1027,1027,1027,1027,1027,0,0}};

{{0,0,0,0,0,0,0,0,0,0,0,0},{0,0,0,0,0,0,0,0,0,0,0,0},{0,0,0,0,0,0,0,0,0,0,0,0},{0,0,0,0,1000,1000,12,0,0,0,0,0},{0,0,0,1004,0,10,12,1001,0,0,0,0},{0,0,1005,1004,1,11,11,1001,0,0,0,0},{1006,1006,1005,14,14,13,13,0,1009,0,0,0},{0,0,0,0,15,15,1002,1002,1009,0,0,0},{1007,1007,1007,17,0,0,1009,1009,1009,0,0,0},{0,0,1007,1008,1008,1008,0,0,0,0,0,0},{0,0,0,0,0,0,0,0,0,0,0,0},{0,0,0,0,0,0,0,0,0,0,0,0}};

{{0,0,0,0,0,0,0,1029,1029,1029,1029,1029,0,1030,1030},{0,0,0,0,0,0,0,1029,1034,0,1033,1031,0,1030,1030},{0,0,0,0,0,0,0,17,17,0,0,1022,0,1030,0},{1026,1026,1026,1026,1026,1026,1026,17,0,0,0,0,0,1030,0},{1026,0,0,0,0,12,12,13,0,1022,0,1021,0,1030,0},{1026,1026,1017,0,1012,1,0,13,13,0,14,1021,1021,0,0},{0,0,1017,0,0,1010,1010,1010,1010,15,14,0,1021,0,0},{0,0,1017,1017,0,0,0,0,0,0,0,1021,1021,0,0},{0,0,0,1017,1017,1017,1017,1017,1017,1017,1017,1021,0,0,0},{0,0,0,0,0,0,1017,1017,0,0,0,1021,0,0,0},{0,0,0,0,0,0,0,0,0,0,0,1021,0,0,0},{0,0,0,0,0,0,0,0,0,0,0,1021,0,0,0}};

{{0,0,0,0,0,1011,1011,1011,1011,1011,0,0,0,0,0},{0,1017,1017,0,0,36,0,1011,0,37,0,0,1015,1015,0},{0,1017,10,10,10,0,0,0,0,0,17,17,17,1015,0},{0,0,10,10,10,0,75,0,64,0,17,17,17,0,0},{0,0,10,10,10,46,81,81,81,34,17,17,17,0,0},{1012,38,0,0,46,46,0,81,0,34,34,0,0,43,1014},{1012,0,0,61,82,0,49,0,50,0,80,74,0,0,1014},{1012,1012,0,0,82,82,0,1,0,80,80,0,0,1014,1014},{1012,0,0,76,82,0,48,0,51,0,80,83,0,0,1014},{1012,39,0,0,21,21,0,79,0,47,47,0,0,42,1014},{0,0,11,11,11,21,79,79,79,47,12,12,12,0,0},{0,0,11,11,11,0,67,0,73,0,12,12,12,0,0},{0,1003,11,11,11,0,0,0,0,0,12,12,12,1004,0},{0,1003,1003,0,0,40,0,1013,0,41,0,0,1004,1004,0},{0,0,0,0,0,1013,1013,1013,1013,1013,0,0,0,0,0}};

{{0,0,1024,0,0,0,0,0,0,0,0,0,0,0,0,0,1025,0,0},{1020,0,84,84,84,84,84,1011,1011,1011,1011,1011,85,85,85,85,85,0,1021},{0,0,84,1017,1017,0,0,36,0,1011,0,37,0,0,1015,1015,85,0,0},{0,0,84,1017,10,10,10,0,0,0,0,0,17,17,17,1015,85,0,0},{0,0,84,0,10,10,10,0,75,0,64,0,17,17,17,0,85,0,0},{0,0,84,0,10,10,10,46,81,81,81,34,17,17,17,0,85,0,0},{0,0,1012,38,0,0,46,46,0,81,0,34,34,0,0,43,1014,0,0},{0,0,1012,0,0,61,82,0,49,0,50,0,80,74,0,0,1014,0,0},{0,0,1012,1012,0,0,82,82,0,1,0,80,80,0,0,1014,1014,0,0},{0,0,1012,0,0,76,82,0,48,0,51,0,80,83,0,0,1014,0,0},{0,0,1012,39,0,0,21,21,0,79,0,47,47,0,0,42,1014,0,0},{0,0,87,0,11,11,11,21,79,79,79,47,12,12,12,0,86,0,0},{0,0,87,0,11,11,11,0,67,0,73,0,12,12,12,0,86,0,0},{0,0,87,1003,11,11,11,0,0,0,0,0,12,12,12,1004,86,0,0},{0,0,87,1003,1003,0,0,40,0,1013,0,41,0,0,1004,1004,86,0,0},{1019,0,87,87,87,87,87,1013,1013,1013,1013,1013,86,86,86,86,86,0,1018},{0,0,1022,0,0,0,0,0,0,0,0,0,0,0,0,0,1023,0,0}};

{{0,1003,1003,1002,1002,0,1005},{1004,0,0,13,0,0,1005},{1004,0,0,0,1006,0,1012},{1009,0,0,12,0,1011,1011},{1009,0,14,0,1,1013,0},{0,0,1001,0,1008,11,11},{0,0,1001,1007,0,1010,0}};

{{0,0,13,0,1002,1002,0},{0,0,0,1006,15,0,0},{1010,1010,0,1006,0,12,12},{1005,0,1007,1007,14,11,0},{1005,1011,0,0,1,11,1009},{1003,1011,1004,1004,0,0,1009},{1012,1012,0,1008,1001,1001,0}};


//LUCA LEVEL

{{0,1033,0,1032,0,1031,0,1030,0,1029,0,1028},{1034,0,21,21,21,21,21,21,21,21,21,0},{0,0,21,1008,1008,1008,0,0,0,0,19,1023},{1035,0,21,1008,0,0,11,1003,1003,0,19,0},{0,0,21,1008,0,0,11,1,1003,0,19,1048},{1036,0,21,1008,17,17,1004,10,10,0,19,0},{0,0,21,0,0,0,16,0,0,1009,19,1047},{1037,1026,1026,1019,0,0,16,0,0,1009,19,0},{0,0,0,1019,1019,0,1009,1009,1009,1009,19,1046},{1038,0,1027,0,1025,19,19,19,19,19,19,0},{0,0,0,0,1025,0,0,0,0,0,0,1045},{1039,0,1040,0,1041,0,1042,0,1043,0,1044,0}};

{{1002,1002,1002,1002,1002,1002,1002,1002,1002,1002,1002,1002,1002,1002,1002,1002,1002,1002},{1002,2,0,0,0,0,0,0,0,0,0,0,0,0,0,0,0,1002},{1002,0,2,0,0,0,0,0,0,0,0,0,0,0,0,0,0,1002},{1002,0,10,2,0,0,0,0,0,0,0,0,0,0,0,0,0,1002},{1002,0,10,10,10,10,10,10,0,0,0,0,0,0,0,0,0,1002},{1002,0,0,0,0,0,0,0,0,0,0,0,0,0,0,0,0,1002},{1002,0,0,0,0,0,0,11,11,11,11,11,11,11,0,0,0,1002},{1002,0,0,0,0,0,0,0,0,0,0,0,0,0,0,0,0,1002},{1002,0,0,0,0,0,0,0,0,0,0,0,0,0,0,0,0,1002},{1002,0,0,0,0,0,0,0,0,0,0,0,0,0,0,0,0,1002},{1002,0,0,0,0,0,0,0,0,0,0,0,0,0,0,0,0,1002},{1002,0,0,0,0,0,0,0,0,0,0,0,0,0,0,0,0,1002},{1002,0,0,0,0,0,0,0,0,0,0,0,0,0,0,0,0,1002},{1002,0,0,0,0,0,0,0,0,0,0,0,0,0,0,0,0,1002},{1002,0,0,0,0,0,0,0,0,0,0,0,0,0,0,0,0,1002},{1002,0,0,0,0,0,0,0,0,0,0,0,0,0,0,0,0,1002},{1002,0,0,0,0,0,0,0,0,0,0,0,0,0,0,0,0,0},{1002,1002,1002,1002,1002,1002,1002,1002,1002,1002,1002,1002,1002,1002,1002,1002,0,0}};

//AUTO GENERATED

{{1007,1007,0,1012,1010,15,15},{0,0,13,1012,1006,1006,1011},{1014,1009,13,1013,0,0,1001},{1008,1008,1004,1015,0,11,1001},{0,0,0,1015,1,11,0},{14,12,1003,0,1002,0,0},{0,12,1003,0,1002,1005,1005}};

{{0,0,0,1008,1008,1003,1003},{1012,1015,1015,0,1006,1001,1001},{1012,0,1011,11,15,1010,1014},{0,0,18,11,0,0,1014},{1007,1016,12,16,1,1002,1002},{14,1013,1013,0,0,1004,1004},{14,13,13,1005,1005,1009,17}};

{{0,0,0,1008,0,0,1013},{0,1002,1002,1009,1009,1014,1014},{11,0,15,0,16,0,14},{11,1001,0,13,0,1006,1012},{1011,1001,12,13,1,1007,1012},{1011,1003,12,0,0,1004,0},{1015,1015,1005,1005,1010,1004,17}};

{{11,15,15,0,0,0,1005,0},{11,0,0,0,1015,1015,1005,0},{1004,1004,0,12,13,1014,16,0},{0,0,1002,0,19,0,1008,1003},{0,0,1007,20,20,0,1008,1003},{1011,1012,18,0,17,1,1001,0},{0,1012,18,0,14,1006,1001,0},{1009,1009,0,0,1013,1013,1010,1010}};

{{1007,1007,1001,1011,0,17,1008},{0,12,0,0,1002,0,1008},{0,11,0,14,1015,1004,1009},{1012,11,16,14,0,1004,1009},{1012,13,0,0,1,1013,0},{0,15,15,1010,1010,1013,1005},{1003,1003,0,1006,0,1014,1005}};

//AUTO GENERATE NOW

{{0,13,1009,0,1001,1001,1012},{17,13,1009,15,18,1007,1012},{11,11,19,15,0,1007,1014},{1004,0,1010,14,14,0,1002},{1013,0,12,12,1,1008,0},{20,1005,0,16,0,1008,1011},{1003,1005,0,1006,1006,0,1011}};

{{1010,1010,1008,0,1002,1013,1009},{13,13,1008,0,1005,1001,0},{0,1006,0,0,1005,1001,1007},{0,1006,0,15,15,0,1007},{1003,14,14,0,1,0,1012},{1003,11,11,0,0,0,1012},{0,12,0,1004,1004,1011,0}};

{{1011,0,1001,1001,1004,1008,0},{1011,0,0,0,1009,1008,0},{1014,11,14,14,13,16,0},{1014,11,0,0,13,0,1007},{1002,1003,1003,0,1,0,1007},{1006,0,1012,12,1005,1010,0},{0,15,0,1013,0,1010,0}};

{{1007,1007,1001,1011,0,17,1008},{0,12,0,0,1002,0,1008},{0,11,0,14,1015,1004,1009},{1012,11,16,14,0,1004,1009},{1012,13,0,0,1,1013,0},{0,15,15,1010,1010,1013,1005},{1003,1003,0,1006,0,1014,1005}};

//Alexander Level

{{1001,1001,1001,1001,1001,1005,1001,1001,1001,1001,1001,1001,1001,1001,1001,1001},{1001,0,0,0,0,1005,0,0,0,0,0,0,0,0,0,1001},{1001,0,1,0,0,1005,0,0,0,0,0,0,0,0,0,1001},{1001,0,0,30,30,30,30,30,0,0,0,23,0,0,0,1001},{1001,1004,1004,1004,1004,1004,0,23,23,23,0,23,0,0,0,1001},{1001,0,0,28,28,28,0,23,28,23,23,23,0,0,0,1001},{1001,24,24,24,24,28,28,28,28,0,0,0,0,21,21,1001},{1006,1006,1006,1006,0,0,0,0,1003,1003,1003,1003,1003,1003,1003,1001},{1001,0,0,0,0,0,0,1007,0,0,0,0,0,0,0,1001},{1001,0,0,0,0,0,0,0,15,0,0,0,0,16,16,1001},{1001,0,0,0,0,0,0,0,15,0,16,16,16,16,16,1001},{1001,0,0,0,0,0,15,15,15,0,0,0,0,0,0,1001},{1001,0,0,0,13,0,15,0,1002,0,0,0,0,0,0,1001},{1001,13,13,13,13,13,15,0,0,0,0,0,0,0,0,1001},{1001,1001,0,1001,1001,1001,1001,1001,1001,1001,1001,1001,1001,1001,1001,1001}};
//GOOD STANDALONE LEVELS:

{{105,102,103,0,101,0,0},{1004,1004,107,0,1011,0,1007},{0,1010,1010,1003,0,0,1007},{1002,0,0,0,0,0,0},{1002,0,109,104,0,1001,1001},{1006,0,0,0,1,1,1009},{1005,1005,108,1008,1008,106,0}};

{{0,1005,0,1010,1010,0,0},{0,0,0,103,1002,0,0},{1008,105,105,103,1,1,1001},{1008,0,0,0,0,0,1001},{106,106,1007,0,1012,1009,1004},{1006,101,104,104,0,1009,1004},{1003,1003,0,102,0,0,1011}};

{{0,0,0,0,1010,1010,0},{0,0,0,0,0,1003,0},{1004,1004,0,0,0,1,0},{101,0,104,1001,107,1,1007},{101,0,0,1008,0,0,1009},{102,102,103,105,106,0,1009},{0,0,1005,1006,1002,1002,0}};

{{0,0,1004,1004,1008,0,1010},{1009,0,1013,0,0,102,1006},{0,105,1,0,0,102,1005},{0,1007,1,103,0,0,1005},{0,0,0,104,0,0,0},{0,1003,1002,1001,1012,1012,101},{1011,1003,1002,1001,0,0,101}};

{{0,0,1004,0,0,0,0,1012,1012,108,0},{0,0,1004,0,0,0,0,1012,1012,0,0},{0,1013,1013,0,0,0,1006,1006,1010,0,103},{0,0,0,0,0,0,0,0,1003,0,103},{0,1005,1005,0,0,105,105,106,1,1007,0},{0,1005,1005,0,1011,1011,0,106,1,1009,0},{0,0,0,0,0,0,0,102,0,1009,0},{101,0,107,0,1014,1001,1001,0,0,0,104},{101,0,0,1008,0,1001,1001,1002,1002,0,0}};

//little good mechanic:

{{0,1009,0,1011,1008,0,1012},{1010,0,0,103,1008,1013,1012},{1010,102,0,0,0,1013,1005},{1002,0,104,0,101,0,1001},{1004,0,104,105,101,0,0},{1004,1,1,105,0,1003,1003},{0,1007,0,1006,0,0,0}};

{{0,0,0,0,1010,102,1002},{0,0,0,0,0,102,0},{0,0,1008,1008,105,0,0},{1003,106,0,101,101,0,1005},{1003,106,0,0,0,103,1004},{0,1006,0,1,0,104,1004},{0,1006,1007,1007,1009,0,1001}};

{{0,0,1004,1004,1008,0,1010},{1009,0,1013,0,0,102,1006},{0,105,1,0,0,102,1005},{0,1007,1,103,0,0,1005},{0,0,0,104,0,0,0},{0,1003,1002,1001,1012,1012,101},{1011,1003,1002,1001,0,0,101}};

{{0,1004,1004,0,1009,1009,0},{0,102,1007,0,1008,1008,1011},{0,0,0,0,0,1,1011},{0,103,1001,107,107,1,0},{0,101,0,104,106,0,1010},{1005,105,0,104,106,0,1010},{1002,1003,1003,0,1006,1006,0}};

{{0,0,0,0,1010,102,1002},{0,0,0,0,0,102,0},{0,0,1008,1008,105,0,0},{1003,106,0,101,101,0,1005},{1003,106,0,0,0,103,1004},{0,1006,0,1,0,104,1004},{0,1006,1007,1007,1009,0,1001}};

{{1004,0,1001,1001,0,0,0},{1004,0,103,102,102,0,1006},{1005,0,103,0,1,1,1006},{1005,0,0,0,1008,101,106},{0,104,105,105,1008,101,1007},{0,104,0,1003,0,0,1007},{0,1002,0,1003,0,0,0}};

{{105,1010,1004,1004,1008,0,0},{105,0,1005,0,0,108,108},{1006,104,1005,107,109,109,0},{1003,104,0,107,106,106,1009},{1003,0,0,0,0,0,1002},{1007,1007,101,1,102,102,1002},{0,103,1011,1011,0,1001,0}};

{{0,0,0,1008,1008,0,101},{0,1004,1,1,0,0,1007},{0,1004,0,105,0,0,1007},{0,0,0,0,1003,0,0},{0,102,0,1001,0,1006,0},{104,102,0,0,0,1009,1002},{104,0,0,0,103,1005,0}};

{{106,0,102,0,0,103},{1005,1001,102,1008,0,1007},{0,0,0,104,104,1007},{1004,0,105,1,1,1009},{1004,0,101,0,0,1009},{0,0,1002,1006,1003,1003}};

{{1010,0,0,0,0,1003,1003,0,0,0,0},{1006,102,1002,1002,0,1003,1003,0,0,0,0},{1006,102,0,0,0,0,0,0,0,0,0},{0,103,0,106,106,101,0,1007,0,107,0},{1012,103,0,0,104,105,0,1007,0,107,1001},{1012,0,1,1,104,0,0,0,0,0,1001},{108,108,1,1,0,0,0,0,1011,0,110},{108,108,1009,1009,0,0,109,1004,1005,1005,110},{1008,1008,1009,1009,0,0,0,1004,1005,1005,0}};

{{0,0,0,0,1001,0,0,0},{0,0,1009,1009,1001,0,1004,1004},{106,106,0,0,0,0,0,0},{1011,1011,1,1,105,105,1010,0},{1011,1011,1,1,0,104,1010,101},{0,0,103,103,0,0,0,0},{0,0,0,0,0,108,108,0},{0,1002,1002,0,1003,0,107,107},{1005,1002,1002,1008,1003,0,0,0},{0,0,0,1008,1006,1006,0,1007},{102,0,0,0,0,0,0,1007}};

{{0,1005,1005,0,0,1009,0,0,0,0},{0,1005,1005,1004,0,0,0,0,0,1013},{0,1002,0,1004,0,108,0,0,0,1013},{1008,0,0,1014,1014,0,1010,1010,107,107},{0,1001,0,1014,1014,0,0,0,0,0},{0,0,0,0,0,0,0,0,0,0},{1012,1012,0,1,1,0,1003,0,105,0},{1012,1012,101,1,1,0,1003,0,0,0},{103,103,109,0,106,0,1011,0,0,0},{0,0,0,104,0,0,1011,0,0,0},{0,0,0,1007,1007,0,1006,102,0,0}};

{{1009,1009,110,110,0,0,0},{1009,1009,1007,1012,1012,108,108},{1011,1011,1,0,0,1004,0},{1011,1011,106,106,0,1008,1008},{1006,1006,104,0,0,1002,0},{1006,1006,101,1010,1010,1002,0},{103,0,0,1010,1010,0,0},{103,0,0,0,105,102,1003},{0,1005,0,0,109,109,1003},{0,107,1001,0,109,109,0}};

{{0,101,0,1010,1010,0,0,0,0,0,0},{1004,1004,0,1010,1010,0,0,0,0,1003,0},{0,109,109,103,0,110,110,0,0,1003,0},{1002,1002,0,103,102,110,110,0,0,0,0},{1002,1002,1,1,0,0,1007,1007,0,0,0},{108,108,1,1,106,0,0,0,0,1001,0},{108,108,104,1011,1006,1006,0,0,0,1009,1009},{1008,0,0,1011,0,0,107,1005,1005,1009,1009},{1008,0,105,0,0,0,107,1005,1005,0,0}};

{{0,0,0,0,0,107,0,0,0},{1011,1004,1004,0,1005,0,0,0,0},{0,0,0,1013,1013,1014,1014,0,0},{0,0,108,0,103,0,1010,104,0},{0,1009,1009,1,1,0,0,104,1007},{0,1009,1009,1,1,0,110,0,1007},{109,1002,102,102,106,0,110,0,0},{109,1001,0,0,0,0,101,1012,1012},{0,1001,0,0,105,105,0,1012,1012},{0,1006,0,0,0,1003,0,0,0},{1008,1008,0,0,0,1003,0,0,0}};

{{0,109,0,1001,1001,1009,1009,0},{1002,0,0,0,1013,1013,0,0},{0,1008,1008,0,0,0,0,1007},{0,1008,1008,110,0,105,0,1007},{1012,0,0,1,1,102,1005,1005},{1012,0,0,1,1,107,1005,1005},{1003,0,0,106,106,104,103,0},{1003,1010,1014,1014,0,0,1011,1011},{1004,0,1014,1014,0,0,101,0},{0,0,0,108,108,0,101,1006}};

{{0,0,1007,1007,0,102,102,1009,1009,0,0},{0,0,1007,1007,105,0,0,1009,1009,0,0},{0,0,0,0,0,1011,1011,0,0,0,0},{0,1006,0,0,0,0,0,0,1003,1003,0},{0,1004,0,0,0,0,0,0,0,0,0},{1008,0,0,0,101,101,104,0,0,0,0},{1001,0,0,0,1,1,104,0,0,1002,0},{0,1010,1010,0,1,1,1005,0,1012,1012,0},{0,0,0,0,1013,1013,1005,0,1012,1012,103}};

{{0,0,0,0,0,0,0,102,0},{104,0,1008,1010,0,1009,0,1002,1002},{0,0,1008,1,1,1009,0,1002,1002},{1004,0,0,107,107,1001,0,1005,1005},{1004,0,0,0,0,0,0,1005,1005},{0,0,1003,1003,0,0,0,105,0},{0,0,1003,1003,103,103,1011,105,0},{0,106,1007,0,0,0,1011,0,101},{0,106,1007,0,0,1006,0,1012,1012}};

{{0,1012,1012,0,0,1011,1011,0,106,106},{0,1012,1012,0,0,1011,1011,0,0,0},{0,1,0,1003,102,105,0,0,0,0},{1005,1,0,0,102,0,0,0,1013,0},{1005,0,0,104,0,1009,1009,0,1013,0},{1007,1007,0,103,0,1009,1009,1002,0,101},{0,1001,0,103,0,0,0,1002,0,0},{0,1001,1006,0,1008,1008,0,0,1004,1004},{0,0,0,1010,1008,1008,0,0,0,0}};

{{0,108,0,0,104,104,0,0,0,0},{0,0,0,0,1009,0,1002,0,0,0},{0,0,0,0,1009,0,0,1004,0,0},{102,102,1001,0,101,0,0,1,1,1006},{0,106,1001,0,103,103,105,0,0,1006},{0,106,0,0,0,0,105,0,1005,1005},{0,0,109,0,0,1007,1007,0,1005,1005},{0,0,109,1003,1003,1007,1007,0,0,107},{0,0,0,1008,0,0,0,0,0,107}};

{{0,1009,1009,0,1014,1014,0,0,0,0},{0,1009,1009,0,106,0,0,1005,0,1006},{0,0,0,0,106,1,1,0,0,103},{0,102,102,107,107,1,1,104,1007,103},{101,101,1001,1001,0,0,0,0,0,0},{0,1013,0,0,105,0,0,1002,1011,1011},{0,1013,1010,1010,0,1008,1008,0,0,0},{0,1003,0,0,0,0,1012,0,1004,0},{0,0,0,0,0,0,1012,0,1004,0}};

{{110,110,0,0,1002,0,0,0,0,0,0},{110,110,0,0,1002,0,0,1006,1006,0,0},{1003,1003,1009,0,0,0,1001,1001,0,0,0},{1003,1003,1009,0,0,0,1,1,0,1005,1005},{0,0,1008,102,0,107,107,109,109,1005,1005},{0,0,1008,0,0,107,107,109,109,105,105},{108,0,0,1007,1007,1010,1010,0,0,105,105},{108,104,104,1007,1007,1010,1010,0,1012,1012,0},{106,104,104,1004,0,0,0,0,0,101,0},{1011,0,0,1004,103,103,0,0,0,101,0}};

{{0,0,0,1009,1010,1010,105,105},{0,0,0,0,1,0,1005,1005},{0,1007,1007,0,1,0,1005,1005},{103,1007,1007,0,106,0,0,0},{1011,0,1002,1002,106,101,1006,1006},{1011,0,1002,1002,0,0,1006,1006},{0,1003,1003,0,0,0,0,0},{0,0,0,0,1008,102,0,0},{0,0,104,0,0,0,0,0},{0,0,0,0,1001,1004,1004,0}};
//NEW GEN





//21 big: 21
{{0,0,0,1009,1010,1010,105,105},{0,0,0,0,1,0,1005,1005},{0,1007,1007,0,1,0,1005,1005},{103,1007,1007,0,106,0,0,0},{1011,0,1002,1002,106,101,1006,1006},{1011,0,1002,1002,0,0,1006,1006},{0,1003,1003,0,0,0,0,0},{0,0,0,0,1008,102,0,0},{0,0,104,0,0,0,0,0},{0,0,0,0,1001,1004,1004,0}};

//21 big: 21
{{0,0,0,1009,1010,1010,105,105},{0,0,0,0,1,0,1005,1005},{0,1007,1007,0,1,0,1005,1005},{103,1007,1007,0,106,0,0,0},{1011,0,1002,1002,106,101,1006,1006},{1011,0,1002,1002,0,0,1006,1006},{0,1003,1003,0,0,0,0,0},{0,0,0,0,1008,102,0,0},{0,0,104,0,0,0,0,0},{0,0,0,0,1001,1004,1004,0}};

//21 big: 21
{{0,0,1004,0,0,0,0,1012,1012,108,0},{0,0,1004,0,0,0,0,1012,1012,0,0},{0,1013,1013,0,0,0,1006,1006,1010,0,103},{0,0,0,0,0,0,0,0,1003,0,103},{0,1005,1005,0,0,105,105,106,1,1007,0},{0,1005,1005,0,1011,1011,0,106,1,1009,0},{0,0,0,0,0,0,0,102,0,1009,0},{101,0,107,0,1014,1001,1001,0,0,0,104},{101,0,0,1008,0,1001,1001,1002,1002,0,0}};

//21 big: 21
{{0,0,0,1009,1010,1010,105,105},{0,0,0,0,1,0,1005,1005},{0,1007,1007,0,1,0,1005,1005},{103,1007,1007,0,106,0,0,0},{1011,0,1002,1002,106,101,1006,1006},{1011,0,1002,1002,0,0,1006,1006},{0,1003,1003,0,0,0,0,0},{0,0,0,0,1008,102,0,0},{0,0,104,0,0,0,0,0},{0,0,0,0,1001,1004,1004,0}};

//21 big: 21
{{0,0,1004,0,0,0,0,1012,1012,108,0},{0,0,1004,0,0,0,0,1012,1012,0,0},{0,1013,1013,0,0,0,1006,1006,1010,0,103},{0,0,0,0,0,0,0,0,1003,0,103},{0,1005,1005,0,0,105,105,106,1,1007,0},{0,1005,1005,0,1011,1011,0,106,1,1009,0},{0,0,0,0,0,0,0,102,0,1009,0},{101,0,107,0,1014,1001,1001,0,0,0,104},{101,0,0,1008,0,1001,1001,1002,1002,0,0}};

//21 big: 21
{{0,0,1004,0,0,0,0,1012,1012,108,0},{0,0,1004,0,0,0,0,1012,1012,0,0},{0,1013,1013,0,0,0,1006,1006,1010,0,103},{0,0,0,0,0,0,0,0,1003,0,103},{0,1005,1005,0,0,105,105,106,1,1007,0},{0,1005,1005,0,1011,1011,0,106,1,1009,0},{0,0,0,0,0,0,0,102,0,1009,0},{101,0,107,0,1014,1001,1001,0,0,0,104},{101,0,0,1008,0,1001,1001,1002,1002,0,0}};

//21 big: 21
{{0,0,0,1009,1010,1010,105,105},{0,0,0,0,1,0,1005,1005},{0,1007,1007,0,1,0,1005,1005},{103,1007,1007,0,106,0,0,0},{1011,0,1002,1002,106,101,1006,1006},{1011,0,1002,1002,0,0,1006,1006},{0,1003,1003,0,0,0,0,0},{0,0,0,0,1008,102,0,0},{0,0,104,0,0,0,0,0},{0,0,0,0,1001,1004,1004,0}};

//21 big: 21
{{0,0,0,1009,1010,1010,105,105},{0,0,0,0,1,0,1005,1005},{0,1007,1007,0,1,0,1005,1005},{103,1007,1007,0,106,0,0,0},{1011,0,1002,1002,106,101,1006,1006},{1011,0,1002,1002,0,0,1006,1006},{0,1003,1003,0,0,0,0,0},{0,0,0,0,1008,102,0,0},{0,0,104,0,0,0,0,0},{0,0,0,0,1001,1004,1004,0}};

//21 big: 21
{{0,0,0,1009,1010,1010,105,105},{0,0,0,0,1,0,1005,1005},{0,1007,1007,0,1,0,1005,1005},{103,1007,1007,0,106,0,0,0},{1011,0,1002,1002,106,101,1006,1006},{1011,0,1002,1002,0,0,1006,1006},{0,1003,1003,0,0,0,0,0},{0,0,0,0,1008,102,0,0},{0,0,104,0,0,0,0,0},{0,0,0,0,1001,1004,1004,0}};

{{0,1001,1001,0,0,0,1007,0,0,1006,1006},{0,1001,1001,0,1004,1004,1007,0,0,1006,1006},{0,0,0,105,105,0,0,1002,0,0,0},{1005,0,0,1,1,0,0,0,1009,0,0},{1005,106,102,1,1,104,0,0,1009,0,0},{0,0,102,0,0,104,0,0,0,0,0},{0,0,101,101,0,0,0,0,0,0,0},{0,0,101,101,1008,1008,0,0,107,0,0},{0,0,0,108,108,0,0,0,1013,1010,0},{0,0,0,0,1012,1012,0,0,1011,0,0},{1003,1003,0,0,0,103,103,0,1011,0,0}};
